instanceId,costs,duration,effective,waiting,offTime
0,3657.0,4194,594,3600,0
1,70688.0,5063,5063,0,0
2,3186.0,1156,1156,0,0
3,48255.0,5346,5346,0,0
4,59016.0,4247,4247,0,0
5,2018.0,1059,1059,0,0
6,69771.0,6591,6591,0,0
7,49959.0,4805,4805,0,0
8,19593.0,2948,2948,0,0
9,86142.0,9038,9038,0,0
10,62691.0,4438,4438,0,0
11,16011.0,2748,2748,0,0
12,314.0,219,219,0,0
13,22458.0,1986,1986,0,0
14,53276.0,6937,6937,0,0
15,38010.0,2578,2578,0,0
16,14708.0,4148,4148,0,0
17,12114.0,1286,1286,0,0
18,143404.0,11780,11780,0,0
19,17945.0,2089,2089,0,0
20,17733.0,219488,2530,216958,0
21,61482.0,216917,9144,207773,0
22,31994.0,200396,3365,197031,0
23,29598.0,180471,5826,174645,0
24,40489.0,159348,3606,155742,0
25,2592.0,131615,407,131208,0
26,27436.0,108734,2415,106319,0
27,72931.0,86140,5200,80940,0
28,50241.0,56965,5540,51425,0
29,38449.0,27956,3834,24122,0
30,80412.0,15348,4610,10738,0
31,36720.0,4067,4067,0,0
32,3220.0,309,309,0,0
33,8892.0,899,899,0,0
34,6884.0,2067,2067,0,0
35,135815.0,12246,12246,0,0
36,21049.0,4038,4038,0,0
37,7072.0,1126,1126,0,0
38,16703.0,2061,2061,0,0
39,268732.0,20587,20587,0,0
40,5558.0,1458,1458,0,0
41,25010.0,3574,3574,0,0
42,37962.0,2636,2636,0,0
43,74955.0,8057,8057,0,0
44,19718.0,2039,2039,0,0
45,114924.0,11743,11743,0,0
46,11968.0,2139,2139,0,0
47,32275.0,5313,5313,0,0
48,22892.0,1835,1835,0,0
49,91622.0,8634,8634,0,0
50,42640.0,237048,6648,0,230400
51,9348.0,208420,1049,207371,0
52,1304.0,192792,823,191969,0
53,42823.0,177035,5616,171419,0
54,1103.0,152115,795,151320,0
55,71772.0,147480,5720,141760,0
56,94120.0,117711,5802,111909,0
57,83780.0,101248,10331,90917,0
58,46719.0,63520,2847,60673,0
59,40234.0,31711,4155,27556,0
60,165041.0,13413,13413,0,0
61,87266.0,8640,8640,0,0
62,7470.0,3476,3476,0,0
63,111665.0,7636,7636,0,0
64,82542.0,7020,7020,0,0
65,26525.0,2167,2167,0,0
66,4522.0,1256,1256,0,0
67,46953.0,3110,3110,0,0
68,15443.0,2443,2443,0,0
69,21384.0,4599,4599,0,0
70,32744.0,2606,2606,0,0
71,44626.0,2724,2724,0,0
72,105950.0,7952,7952,0,0
73,86520.0,8000,8000,0,0
74,40316.0,5605,5605,0,0
75,6776.0,1090,1090,0,0
76,1454.0,792,792,0,0
77,4287.0,1133,1133,0,0
78,15162.0,1395,1395,0,0
79,27408.0,230493,2657,227836,0
80,20293.0,201670,1816,199854,0
81,49746.0,193662,5705,187957,0
82,17865.0,186287,2398,183889,0
83,70922.0,165214,9000,156214,0
84,48433.0,129504,3787,125717,0
85,6606.0,110814,1511,109303,0
86,58783.0,99575,3468,96107,0
87,62923.0,85445,4289,81156,0
88,38223.0,71016,5840,65176,0
89,27143.0,56800,1979,54821,0
90,4826.0,35672,2068,33604,0
91,39679.0,18424,4749,13675,0
92,154465.0,19933,12696,7237,0
93,94457.0,7959,7959,0,0
94,35511.0,2685,2685,0,0
95,257307.0,19611,19611,0,0
96,8084.0,1579,1579,0,0
97,11275.0,1767,1767,0,0
98,58813.0,4678,4678,0,0
99,17135.0,2800,2800,0,0
100,2174.0,510,510,0,0
101,81788.0,7039,7039,0,0
102,27763.0,4267,4267,0,0
103,18098.0,1433,1433,0,0
104,41081.0,3705,3705,0,0
105,15056.0,1667,1667,0,0
106,63852.0,6219,6219,0,0
107,7910.0,1670,1670,0,0
108,6630.0,1152,1152,0,0
109,35303.0,2083,2083,0,0
110,25384.0,2558,2558,0,0
111,50654.0,230277,3472,226805,0
112,14772.0,214611,3118,211493,0
113,19752.0,207858,4259,203599,0
114,17391.0,187660,2680,184980,0
115,21264.0,181136,3591,177545,0
116,32508.0,177655,3498,174157,0
117,88796.0,168216,7008,161208,0
118,9172.0,138067,891,137176,0
119,124025.0,121202,10454,110748,0
120,90945.0,100878,5014,95864,0
121,28187.0,66631,2225,64406,0
122,15890.0,43411,2173,41238,0
123,39040.0,23150,7312,15838,0
124,23259.0,3505,3505,0,0
125,31188.0,5239,5239,0,0
126,5400.0,3252,3252,0,0
127,9655.0,1294,1294,0,0
128,8562.0,1374,1374,0,0
129,94903.0,7343,7343,0,0
130,19643.0,2804,2804,0,0
131,69241.0,7685,7685,0,0
132,4236.0,1028,1028,0,0
133,5800.0,1422,1422,0,0
134,1503.0,911,911,0,0
135,4156.0,566,566,0,0
136,80430.0,6726,6726,0,0
137,4776.0,857,857,0,0
138,2052.0,918,918,0,0
139,136767.0,8202,8202,0,0
140,3726.0,1220,1220,0,0
141,15366.0,1219,1219,0,0
142,1838.0,1172,1172,0,0
143,9944.0,1419,1419,0,0
144,108142.0,9780,9780,0,0
145,103599.0,11216,11216,0,0
146,2442.0,229823,891,228932,0
147,69619.0,222946,4112,218834,0
148,32514.0,193905,3019,190886,0
149,132901.0,181644,9097,172547,0
150,887.0,143270,1082,142188,0
151,80862.0,137052,10069,126983,0
152,45168.0,122872,3404,119468,0
153,2694.0,109393,430,108963,0
154,20795.0,78907,2697,76210,0
155,6324.0,55089,1274,53815,0
156,13984.0,36585,1262,35323,0
157,6449.0,14759,728,14031,0
158,78131.0,6619,6619,0,0
159,52682.0,5430,5430,0,0
160,28575.0,2170,2170,0,0
161,25265.0,2371,2371,0,0
162,6093.0,1463,1463,0,0
163,28224.0,2928,2928,0,0
164,13501.0,1527,1527,0,0
165,168499.0,14901,14901,0,0
166,152607.0,10999,10999,0,0
167,22303.0,3730,3730,0,0
168,12394.0,1221,1221,0,0
169,12222.0,1143,1143,0,0
170,34086.0,2076,2076,0,0
171,18529.0,2507,2507,0,0
172,58946.0,6436,6436,0,0
173,27173.0,2754,2754,0,0
174,102417.0,7122,7122,0,0
175,29335.0,4152,4152,0,0
176,28237.0,2947,2947,0,0
177,7299.0,225594,585,225009,0
178,138084.0,216551,19783,196768,0
179,3300.0,176830,407,176423,0
180,7790.0,145351,1259,144092,0
181,24688.0,122775,2494,120281,0
182,113070.0,122683,9096,113587,0
183,47327.0,113282,7485,105797,0
184,12526.0,93002,1325,91677,0
185,120891.0,87519,8910,78609,0
186,111434.0,74554,8444,66110,0
187,5606.0,41936,4432,37504,0
188,16592.0,36968,2188,34780,0
189,13008.0,7309,934,6375,0
190,76724.0,6084,6084,0,0
191,98191.0,8959,8959,0,0
192,60073.0,5396,5396,0,0
193,21865.0,2713,2713,0,0
194,8709.0,1829,1829,0,0
195,23698.0,2550,2550,0,0
196,2896.0,745,745,0,0
197,123551.0,8476,8476,0,0
198,33055.0,3730,3730,0,0
199,15556.0,1253,1253,0,0
200,8054.0,1467,1467,0,0
201,50876.0,5724,5724,0,0
202,14501.0,1436,1436,0,0
203,8373.0,1237,1237,0,0
204,26772.0,2778,2778,0,0
205,6996.0,1031,1031,0,0
206,76858.0,5591,5591,0,0
207,8794.0,227980,1653,226327,0
208,54050.0,223296,5682,217614,0
209,73994.0,210227,6501,203726,0
210,70510.0,202663,5790,196873,0
211,94303.0,199576,7157,192419,0
212,6350.0,168904,1152,167752,0
213,94974.0,145172,9298,135874,0
214,41321.0,125652,4518,121134,0
215,96734.0,108591,7208,101383,0
216,15768.0,87295,1302,85993,0
217,53761.0,65886,6812,59074,0
218,41670.0,52350,5322,47028,0
219,9486.0,32218,1594,30624,0
220,28287.0,3819,3819,0,0
221,19795.0,1630,1630,0,0
222,173939.0,15197,15197,0,0
223,74267.0,5399,5399,0,0
224,60513.0,4141,4141,0,0
