instanceId,costs,duration,effective,waiting,offTime
0,9712.0,4194,594,3600,0
1,57792.0,5063,5063,0,0
2,12651.0,1156,1156,0,0
3,45444.0,5346,5346,0,0
4,21465.0,4247,4247,0,0
5,10206.0,1059,1059,0,0
6,49410.0,6591,6591,0,0
7,53799.0,4805,4805,0,0
8,17606.0,2948,2948,0,0
9,62925.0,9038,9038,0,0
10,49815.0,4438,4438,0,0
11,14001.0,2748,2748,0,0
12,3198.0,219,219,0,0
13,15741.0,1986,1986,0,0
14,52637.0,6937,6937,0,0
15,15340.0,2578,2578,0,0
16,44346.0,4148,4148,0,0
17,17008.0,1286,1286,0,0
18,137857.0,11780,11780,0,0
19,19212.0,2089,2089,0,0
20,12096.0,219025,2067,216958,0
21,90037.0,218130,7925,210205,0
22,56336.0,203158,5188,197970,0
23,6419.0,176523,817,175706,0
24,39051.0,165383,4222,161161,0
25,10422.0,138897,5537,133360,0
26,40242.0,115724,4009,111715,0
27,45617.0,89652,4226,85426,0
28,22294.0,56351,1754,54597,0
29,94012.0,36497,7313,29184,0
30,28752.0,20143,3419,16724,0
31,41788.0,4067,4067,0,0
32,1596.0,309,309,0,0
33,6047.0,899,899,0,0
34,18778.0,2067,2067,0,0
35,104429.0,12246,12246,0,0
36,39246.0,4038,4038,0,0
37,10169.0,1126,1126,0,0
38,22517.0,2061,2061,0,0
39,181347.0,20587,20587,0,0
40,22673.0,1458,1458,0,0
41,39536.0,3574,3574,0,0
42,28470.0,2636,2636,0,0
43,74354.0,8057,8057,0,0
44,20044.0,2039,2039,0,0
45,113190.0,11743,11743,0,0
46,22758.0,2139,2139,0,0
47,51680.0,5313,5313,0,0
48,14859.0,1835,1835,0,0
49,80003.0,8634,8634,0,0
50,100340.0,238471,7332,739,230400
51,7871.0,208420,1049,207371,0
52,7007.0,192909,823,192086,0
53,14965.0,172712,1041,171671,0
54,42482.0,159399,4874,154525,0
55,150602.0,159455,15868,143587,0
56,67918.0,119997,6254,113743,0
57,26803.0,97644,3636,94008,0
58,33564.0,65282,2891,62391,0
59,14842.0,33987,3116,30871,0
60,72184.0,8380,8067,313,0
61,46958.0,10052,10052,0,0
62,38699.0,4312,4312,0,0
63,46538.0,7636,7636,0,0
64,54708.0,7020,7020,0,0
65,14259.0,2167,2167,0,0
66,13126.0,1256,1256,0,0
67,29646.0,3110,3110,0,0
68,23614.0,2443,2443,0,0
69,30930.0,4599,4599,0,0
70,28794.0,2606,2606,0,0
71,33335.0,2724,2724,0,0
72,77717.0,7952,7952,0,0
73,71530.0,8000,8000,0,0
74,37487.0,5605,5605,0,0
75,17710.0,1090,1090,0,0
76,6246.0,792,792,0,0
77,8359.0,1133,1133,0,0
78,15721.0,1395,1395,0,0
79,24583.0,230493,2657,227836,0
80,18465.0,201718,1816,199902,0
81,186699.0,208043,18069,189974,0
82,32990.0,190928,3625,187303,0
83,42667.0,164633,5257,159376,0
84,20961.0,128831,1641,127190,0
85,10725.0,112826,1125,111701,0
86,21391.0,101676,2451,99225,0
87,23535.0,90299,4966,85333,0
88,4378.0,70559,2899,67660,0
89,91761.0,64813,7673,57140,0
90,78816.0,48632,10473,38159,0
91,17748.0,17782,1984,15798,0
92,15397.0,11514,1542,9972,0
93,17876.0,3418,3118,300,0
94,20860.0,3311,3311,0,0
95,159583.0,19611,19611,0,0
96,9464.0,1579,1579,0,0
97,15170.0,1767,1767,0,0
98,30155.0,4678,4678,0,0
99,15143.0,2800,2800,0,0
100,3963.0,510,510,0,0
101,72178.0,7039,7039,0,0
102,37310.0,4267,4267,0,0
103,12134.0,1433,1433,0,0
104,34198.0,3705,3705,0,0
105,14826.0,1667,1667,0,0
106,66514.0,6219,6219,0,0
107,17140.0,1670,1670,0,0
108,19715.0,1152,1152,0,0
109,17847.0,2083,2083,0,0
110,33972.0,2558,2558,0,0
111,31364.0,230277,3472,226805,0
112,4037.0,214611,3118,211493,0
113,36912.0,207858,4259,203599,0
114,23637.0,187660,2680,184980,0
115,24249.0,180921,3376,177545,0
116,107919.0,183336,8670,174666,0
117,72405.0,168366,6817,161549,0
118,9234.0,139266,1223,138043,0
119,102543.0,122892,10624,112268,0
120,48537.0,105060,6606,98454,0
121,4238.0,68905,522,68383,0
122,22482.0,46063,2096,43967,0
123,9448.0,20411,937,19474,0
124,27492.0,5162,4800,362,0
125,41732.0,5239,5239,0,0
126,31448.0,3252,3252,0,0
127,6683.0,1294,1294,0,0
128,11612.0,1374,1374,0,0
129,77249.0,7343,7343,0,0
130,21094.0,2804,2804,0,0
131,77138.0,7685,7685,0,0
132,11798.0,1028,1028,0,0
133,7543.0,1422,1422,0,0
134,8327.0,911,911,0,0
135,6153.0,566,566,0,0
136,67027.0,6726,6726,0,0
137,13529.0,857,857,0,0
138,9123.0,918,918,0,0
139,91761.0,8202,8202,0,0
140,10911.0,1220,1220,0,0
141,19147.0,1219,1219,0,0
142,9252.0,1172,1172,0,0
143,15948.0,1419,1419,0,0
144,103986.0,9780,9780,0,0
145,122606.0,11216,11216,0,0
146,4768.0,229823,891,228932,0
147,35645.0,223027,4038,218989,0
148,30643.0,196620,5405,191215,0
149,32817.0,176129,3178,172951,0
150,13472.0,143495,1082,142413,0
151,11911.0,129002,1935,127067,0
152,92130.0,128587,8424,120163,0
153,6586.0,110873,517,110356,0
154,25838.0,78868,1860,77008,0
155,56973.0,64113,8373,55740,0
156,68291.0,44474,7523,36951,0
157,8479.0,16999,839,16160,0
158,7012.0,936,619,317,0
159,56626.0,5430,5430,0,0
160,24481.0,2170,2170,0,0
161,26530.0,2371,2371,0,0
162,15379.0,1463,1463,0,0
163,13304.0,2928,2928,0,0
164,16507.0,1527,1527,0,0
165,138946.0,14901,14901,0,0
166,83807.0,10999,10999,0,0
167,41169.0,3730,3730,0,0
168,17892.0,1221,1221,0,0
169,12609.0,1143,1143,0,0
170,29674.0,2076,2076,0,0
171,24589.0,2507,2507,0,0
172,41467.0,6436,6436,0,0
173,25079.0,2754,2754,0,0
174,85409.0,7122,7122,0,0
175,44266.0,4152,4152,0,0
176,29231.0,2947,2947,0,0
177,8271.0,225594,585,225009,0
178,87609.0,210653,11768,198885,0
179,5942.0,176965,407,176558,0
180,18077.0,145571,1259,144312,0
181,48566.0,127568,7287,120281,0
182,57954.0,122179,7560,114619,0
183,6889.0,106806,816,105990,0
184,16862.0,93087,1325,91762,0
185,91815.0,87717,6803,80914,0
186,21333.0,72904,3828,69076,0
187,92563.0,56666,16765,39901,0
188,46391.0,42366,3997,38369,0
189,70414.0,14770,4942,9828,0
190,61296.0,6084,6084,0,0
191,90679.0,8959,8959,0,0
192,37069.0,5396,5396,0,0
193,23536.0,2713,2713,0,0
194,12879.0,1829,1829,0,0
195,40346.0,2550,2550,0,0
196,7606.0,745,745,0,0
197,50172.0,8476,8476,0,0
198,53152.0,3730,3730,0,0
199,7365.0,1253,1253,0,0
200,10585.0,1467,1467,0,0
201,30935.0,5724,5724,0,0
202,19037.0,1436,1436,0,0
203,16580.0,1237,1237,0,0
204,24111.0,2778,2778,0,0
205,11373.0,1031,1031,0,0
206,54626.0,5591,5591,0,0
207,6989.0,227980,1653,226327,0
208,54745.0,221423,3809,217614,0
209,118592.0,219249,10849,208400,0
210,91610.0,205141,8024,197117,0
211,21682.0,196123,3367,192756,0
212,29094.0,175868,2803,173065,0
213,50659.0,143621,5040,138581,0
214,57148.0,133760,9162,124598,0
215,15882.0,108150,2028,106122,0
216,51236.0,97158,4590,92568,0
217,29875.0,66842,3253,63589,0
218,19544.0,60253,5802,54451,0
219,35231.0,41662,3409,38253,0
220,38815.0,8564,5141,3423,0
221,5860.0,2226,508,1718,0
222,113082.0,15197,15197,0,0
223,25776.0,5399,5399,0,0
224,26030.0,4141,4141,0,0
