instanceId,costs,duration,effective,waiting,offTime
0,3657.0,4194,594,3600,0
1,69582.0,5063,5063,0,0
2,10248.0,1156,1156,0,0
3,62556.0,5346,5346,0,0
4,33111.0,4247,4247,0,0
5,17231.0,1059,1059,0,0
6,70435.0,6591,6591,0,0
7,25038.0,4805,4805,0,0
8,29576.0,2948,2948,0,0
9,106314.0,9038,9038,0,0
10,70244.0,4438,4438,0,0
11,24020.0,2748,2748,0,0
12,1830.0,219,219,0,0
13,10451.0,1986,1986,0,0
14,104493.0,6937,6937,0,0
15,28440.0,2578,2578,0,0
16,18599.0,4148,4148,0,0
17,15458.0,1286,1286,0,0
18,97986.0,11780,11780,0,0
19,7709.0,2089,2089,0,0
20,23019.0,219488,2530,216958,0
21,37948.0,211047,3810,207237,0
22,38750.0,200278,3274,197004,0
23,71236.0,179579,4934,174645,0
24,31589.0,158993,3606,155387,0
25,4746.0,131615,407,131208,0
26,34170.0,111472,5471,106001,0
27,54719.0,85810,4892,80918,0
28,28634.0,56383,4998,51385,0
29,116396.0,31788,8025,23763,0
30,33731.0,15258,4530,10728,0
31,19825.0,4067,4067,0,0
32,2975.0,309,309,0,0
33,7613.0,899,899,0,0
34,3828.0,2067,2067,0,0
35,195617.0,12246,12246,0,0
36,26269.0,4038,4038,0,0
37,13603.0,1126,1126,0,0
38,20106.0,2061,2061,0,0
39,213730.0,20587,20587,0,0
40,24773.0,1458,1458,0,0
41,36688.0,3574,3574,0,0
42,41790.0,2636,2636,0,0
43,75300.0,8057,8057,0,0
44,21026.0,2039,2039,0,0
45,110868.0,11743,11743,0,0
46,24942.0,2139,2139,0,0
47,50522.0,5313,5313,0,0
48,19411.0,1835,1835,0,0
49,93892.0,8634,8634,0,0
50,13056.0,237048,6648,0,230400
51,8608.0,208420,1049,207371,0
52,7173.0,192792,823,191969,0
53,74789.0,177035,5616,171419,0
54,2980.0,152115,795,151320,0
55,56607.0,147480,5720,141760,0
56,47009.0,117711,5802,111909,0
57,107498.0,101248,10331,90917,0
58,29949.0,63520,2847,60673,0
59,66331.0,31711,4155,27556,0
60,125695.0,13413,13413,0,0
61,75284.0,8640,8640,0,0
62,64581.0,3476,3476,0,0
63,101036.0,7636,7636,0,0
64,74328.0,7020,7020,0,0
65,36330.0,2167,2167,0,0
66,7300.0,1256,1256,0,0
67,10544.0,3110,3110,0,0
68,21542.0,2443,2443,0,0
69,59316.0,4599,4599,0,0
70,27606.0,2606,2606,0,0
71,15108.0,2724,2724,0,0
72,99457.0,7952,7952,0,0
73,80350.0,8000,8000,0,0
74,71466.0,5605,5605,0,0
75,9790.0,1090,1090,0,0
76,4870.0,792,792,0,0
77,6541.0,1133,1133,0,0
78,9272.0,1395,1395,0,0
79,27573.0,230493,2657,227836,0
80,20139.0,201670,1816,199854,0
81,26329.0,193486,5625,187861,0
82,36284.0,186287,2398,183889,0
83,82679.0,165213,9000,156213,0
84,41812.0,129504,3787,125717,0
85,20919.0,110814,1511,109303,0
86,86448.0,102571,6464,96107,0
87,64481.0,85445,4289,81156,0
88,61646.0,70981,5840,65141,0
89,14136.0,56753,1979,54774,0
90,12260.0,35752,2148,33604,0
91,6066.0,15268,1753,13515,0
92,121946.0,19933,12696,7237,0
93,49614.0,7959,7959,0,0
94,26962.0,2685,2685,0,0
95,203743.0,19611,19611,0,0
96,7247.0,1579,1579,0,0
97,16655.0,1767,1767,0,0
98,70112.0,4678,4678,0,0
99,21498.0,2800,2800,0,0
100,1222.0,510,510,0,0
101,86767.0,7039,7039,0,0
102,33868.0,4267,4267,0,0
103,19380.0,1433,1433,0,0
104,56749.0,3705,3705,0,0
105,16393.0,1667,1667,0,0
106,35937.0,6219,6219,0,0
107,19295.0,1670,1670,0,0
108,12475.0,1152,1152,0,0
109,34910.0,2083,2083,0,0
110,10567.0,2558,2558,0,0
111,47157.0,230277,3472,226805,0
112,5014.0,214611,3118,211493,0
113,68964.0,207858,4259,203599,0
114,24643.0,187660,2680,184980,0
115,11794.0,181136,3591,177545,0
116,39359.0,177655,3498,174157,0
117,89012.0,168216,7008,161208,0
118,8252.0,138067,891,137176,0
119,83163.0,121202,10454,110748,0
120,61328.0,100878,5014,95864,0
121,20239.0,66631,2225,64406,0
122,17655.0,43411,2173,41238,0
123,91091.0,23150,7312,15838,0
124,44977.0,3505,3505,0,0
125,12592.0,5239,5239,0,0
126,23526.0,3252,3252,0,0
127,1995.0,1294,1294,0,0
128,10443.0,1374,1374,0,0
129,60539.0,7343,7343,0,0
130,23817.0,2804,2804,0,0
131,95488.0,7685,7685,0,0
132,5746.0,1028,1028,0,0
133,2476.0,1422,1422,0,0
134,4615.0,911,911,0,0
135,4390.0,566,566,0,0
136,88117.0,6726,6726,0,0
137,10042.0,857,857,0,0
138,3106.0,918,918,0,0
139,79578.0,8202,8202,0,0
140,7809.0,1220,1220,0,0
141,4599.0,1219,1219,0,0
142,10080.0,1172,1172,0,0
143,11260.0,1419,1419,0,0
144,107069.0,9780,9780,0,0
145,84838.0,11216,11216,0,0
146,3640.0,229823,891,228932,0
147,49487.0,222946,4112,218834,0
148,37249.0,193905,3019,190886,0
149,139535.0,181644,9097,172547,0
150,3852.0,143270,1082,142188,0
151,110421.0,137052,10069,126983,0
152,34422.0,122872,3404,119468,0
153,3664.0,109393,430,108963,0
154,23211.0,78907,2697,76210,0
155,2398.0,55089,1274,53815,0
156,13501.0,36585,1262,35323,0
157,3651.0,14759,728,14031,0
158,64453.0,6619,6619,0,0
159,58280.0,5430,5430,0,0
160,13376.0,2170,2170,0,0
161,25553.0,2371,2371,0,0
162,9796.0,1463,1463,0,0
163,51064.0,2928,2928,0,0
164,12367.0,1527,1527,0,0
165,156603.0,14901,14901,0,0
166,153859.0,10999,10999,0,0
167,46957.0,3730,3730,0,0
168,15551.0,1221,1221,0,0
169,16587.0,1143,1143,0,0
170,20016.0,2076,2076,0,0
171,27292.0,2507,2507,0,0
172,49254.0,6436,6436,0,0
173,39909.0,2754,2754,0,0
174,19673.0,7122,7122,0,0
175,57542.0,4152,4152,0,0
176,19148.0,2947,2947,0,0
177,7875.0,225594,585,225009,0
178,289536.0,216551,19783,196768,0
179,3984.0,176830,407,176423,0
180,10937.0,145351,1259,144092,0
181,25903.0,122775,2494,120281,0
182,48288.0,122683,9096,113587,0
183,37124.0,113282,7485,105797,0
184,13490.0,93002,1325,91677,0
185,111781.0,87519,8910,78609,0
186,94072.0,74554,8444,66110,0
187,11761.0,41936,4432,37504,0
188,33820.0,36968,2188,34780,0
189,9926.0,7309,934,6375,0
190,42920.0,6084,6084,0,0
191,99969.0,8959,8959,0,0
192,48117.0,5396,5396,0,0
193,32736.0,2713,2713,0,0
194,4862.0,1829,1829,0,0
195,44811.0,2550,2550,0,0
196,3066.0,745,745,0,0
197,66050.0,8476,8476,0,0
198,50941.0,3730,3730,0,0
199,15168.0,1253,1253,0,0
200,5537.0,1467,1467,0,0
201,61313.0,5724,5724,0,0
202,19605.0,1436,1436,0,0
203,9334.0,1237,1237,0,0
204,35003.0,2778,2778,0,0
205,4734.0,1031,1031,0,0
206,60001.0,5591,5591,0,0
207,16151.0,227980,1653,226327,0
208,44089.0,223296,5682,217614,0
209,152703.0,214668,11141,203527,0
210,53724.0,204659,7976,196683,0
211,58209.0,196406,4425,191981,0
212,17497.0,168904,1152,167752,0
213,80300.0,141003,5129,135874,0
214,50919.0,124329,3869,120460,0
215,90762.0,108591,7208,101383,0
216,10271.0,87085,1409,85676,0
217,18394.0,60694,2290,58404,0
218,30984.0,53898,6870,47028,0
219,42264.0,35500,5185,30315,0
220,40807.0,3819,3819,0,0
221,19288.0,1630,1630,0,0
222,138690.0,15197,15197,0,0
223,59640.0,5399,5399,0,0
224,31544.0,4141,4141,0,0
